#####################
#         #         #
# ### ### # ### ### #
#                   #
# ### # ##### # ### #
#     #   #   #     #
##### ### # ### #####
////# #   b   # #////
##### # ##-## # #####
        #ipc#        
##### # ##### # #####
////# #       # #////
##### # ##### # #####
#         #         #
# ### ### # ### ### #
#   #     P     #   #
### # # ##### # # ###
#     #   #   #     #
# ####### # ####### #
#                   #
#####################