#####################
#     #       #     #
# ### # ##### # ### #
#                   #
### # ### # ### # ###
    #     #     #    
### ### ##### ### ###
//#       b       #//
//# ### ##-## ### #//
//# #   #ipc#   # #//
### # # ##### # # ###
      #       #      
### ##### # ##### ###
//#       #       #//
### ### ##### ### ###
#         P         #
# ### ### # ### ### #
# #/# #   #   # #/# #
# ### # ##### # ### #
#                   #
#####################