#####################
#     # ##### #     #
# ### #   #   # ### #
#   #     #     #   #
### # # # # # # # ###
      # #   # #      
### # # ##### # # ###
#   #     b     #   #
# ### # ##-## # ### #
#     # #ipc# #     #
## #### ##### #### ##
#     #       #     #
# ### # ##### # ### #
#   # #   #   # #   #
### # # # # # # # ###
        # P #        
### # ### # ### # ###
#   #     #     #   #
# ### # ##### # ### #
#     #       #     #
#####################